NO ./textures/metal_brick.xpm
SO ./textures/wood_wall.xpm
WE ./textures/tt3.xpm
EA ./textures/tt4.xpm

F 150,150,150
C 150 ,50,30

11111111111111111111111111111111111 11111  1111111
1111E000000000000000000000000000001 10001  1000011
11110000000000000000000000000000001 10001  1000011
11111000000000000000000000000000001110001  1000011
    1000000000000000000000000000000000001  10000111111
    1000000000000000000000000000000000001  10000000011
    1000000000110121000111112110000000001  10000000011
    1000000001010101000100000010000000001  10000111111
11111000000010011101000111100010000000001111000011
10000000000100000001000000100100000000000000000011
10000000001112111101000001001000000000000000000011
10000000000000000101000010010000000000000000000011
10000000000000000101000100111110000000000000000011
10000000000000000101000100000000000000000000000011
10000000000000000101000112111110000000000000000011
10000000000000000000000000000000000000000000000011
10000000000000000000000000000000000000000000000011
10000000000000000000000000000000000000000000000011
10000000000000000000000000000000000000000000000011
10000000000000000000000000000000000000000000000011
10000000000000000000000000000000000000000000000011
10000000000000000000000000000000000000000000000011
10000000000000000000000000000000000000000000000011
10000000000000000000000000000000000000000000000011
10000000000000000011111111110111111111111111111111
1111111000000000001001     10000100000000000000011111111
      1000000000001001     10000100000000000000000000001
      10000000000010011111110000100000000000000000000001
11111110000000000010000000000000100000000000000011111001
10000000000000000011111111110000100000000000000011111001
10000000000000000010000000000000100000000000000011111001
10000000000000000020000000000000200000000000000011111001
10000000000000000010000000000000100000000000000011111001
10000000000000000010000000000000100000000000000011111001
11111111111100000110111111111211100000000000000011111001
11111111111000000110000000000000000000000000000011110001
11111111110000000110000000000000000000000000000011110001
11110000000000000110000000000000000000000000000011100001
10000111111000000110000000000000000000000000000011000001
10011111111112111111111111111111211111111111111110000001
10000000000000000000000000000000000000000000000000000001
10000000000000000000000000000000000000000000000000000001
11111111111111111111111111111111111111111111111111111111