NO ./textures_bonus/wood_wall_3.xpm
SO ./textures_bonus/wood_wall_2.xpm
WE ./textures_bonus/wall3.xpm
EA ./textures_bonus/tt4.xpm

F 150,150,150
C 150 ,50,30

1111111
1N10001
1100001
1000001
1111111