NO ./path_to_the_north_texture
SO ./path_to_the_south_texture
WE ./path_to_the_west_texture
EA ./path_to_the_east_texture

F 255,220,100
C 12,225,30

111111111111
1000000000001
11W0000000001
111111111111
1111111111
1111111111
1111111111
1111111111
1111111111
1111111111
1111111111