NO ./textures/tt1.xpm
SO ./textures/tt2.xpm
WE ./textures/tt3.xpm
EA ./textures/tt4.xpm

F 150,150,150
C 150 ,50,30

111111111111
1000000000001
11W0000000001
111111111111
1111111111
1111111111
1111111111
1111111111
1111111111
1111111111
1111111111