NO ./textures/wall_2.xpm
SO ./textures/tt1.xpm
WE ./textures/backrooms_texture.xpm
EA ./textures/doom_wall.xpm

F 195,203,110
C 20,255,255

11111111111111111111111
10000000000000000001001
100000000000000010000S1
10001111111111111111111
10001000000000010000111
10001000000000010000111
10001000000000010000111
10001000000000010000111
10001000000000000000111
10001000000000000000111
10001111111111110000111
10001111111111110000111
10000000000000000000111
10000000000000000000111
11111111111111111111111
                                                             
                                                             
                                                             