NO ./textures/tt1.xpm
SO ./textures/tt2.xpm
WE ./textures/tt3.xpm
EA ./textures/tt4.xpm

F 150,150,150
C 150 ,50,30

111111111111111
1000000001110001
100000000011100111
1000000000111001
1110000000010001
1110000000010001
1110000000001001
1010000000S001001
1010000000000101
1000000000000001
111111111111111