NO ./path_to_the_north_texture
SO ./path_to_the_south_texture
WE ./path_to_the_west_texture
EA ./path_to_the_east_texture

F 255,220,100
C 1,225,30

11111111111111111
1000000N0011100001
100000000011100111
1000000000111001
1110000000010001
1110000000010001
1110000000001001
1010000000001001
1010000000000101
1000000000000001
1111111111111111